37
20 50
100
1.0 1.0
-
BBBBBBBBBBBBBBBBBBBBBBBBBBBBBBBBBBBBBBBBBBBBBBBBBB
BM*EEEEEEEEEEEEEEEEEEEEEER****REEEEEEEEEEEEEEEEEEB
BEEEEEEEREEEEEEEEEEEEEEEERRRRRREEEEEEE*EEEEEEEEEEB
BEEEEEEE*EEEEEEEEEEEE***EEEEEEEEEEEEEEEEEEEEEEEEEB
BEEEEEEE*EEEEEEEEEEEEEEEEEEEEEEEEEEEEEE*EEEEEEEEEB
BEEEEEEEEEEEEEEEEEEEEEEEEEEEEEEEEEEEEEEEEEEEEEEEEB
BEEEEEEEEEEEEEEEEEEEEEEEEEEEEEEEEEEEEEE*EEEEEEEEEB
BEE*EEEEEEEEEEEEEEEEEEEEEEEEEEEEEEEEEEEEEEEEEEEEEB
BEEEEEEEEEEEEEEEEEEEERRRREEEEEEEEEEEEEEEEEEEEE*EEB
BEEREEEEEEEERREEEEEER***REEEEEEEEREEEEEEEEEEEEEEEB
BEE*EEEEEEEE**EEEEEERRRRREEEEEEEER**EEEEEEEEEEEEE*B
BE*EEEEEEEEEEEEEEEEEEEEEEEEEEEEEEREEEEEEEEEEE*EEEB
BEEEEEEEEEEEEEEEEEEEEEEEEEEEEERRRREEEEEEEEEEEEEEEB
BEEEEEEEEEEEEEEEEEEEEEEEEEEEER****REEEEEEEEEEEEEEB
BEEEEEEEEEEEEEEE*EEEEEEEEEEEEEREEREEEEEEEEEEEEEEEB
BEEEEEEEEEEEEEEE*EEEEEEEEEEEEEEEEEEEEEEEEEEEEEEEEB
BEEEEEEEEEEEEEEEEEEEEEEEEEEEEEEEEEEEEEE*EEEEEEEEEB
BEEEEEEEEEEEEEEEEEEEEERRERREEEEEEEEEEEEEEEEEEEEEEB
B*EEEEEEEEEEEEEEEEEEEER***REEEEEEEEEEEEEEEEEEEEEEB
BBBBBBBBBBBBBBBBBBBBBBBBBBBBBBBBBBBBBBBBBBBBBBBBBB