154
20 50
100
1.0 1.0
-
BBBBBBBBBBBBBBBBBBBBBBBBBBBBBBBBBBBBBBBBBBBBBBBBBB
BMEEEEEEEEEEEEEEEEBBBBBBBBBBBBBBEEEEEEEEEEEEEEEEEB
BEEEEEEEEEEEEEEEEEEEEEBBBBBBEEEEEEEEEEEEEEEEEEEEEB
BEEEEEEEEEEEEEEEEEEEEEEEEEEEEEEEEEEEEEEEEEEEEEEEEB
BE*****EE*****EE*EE****EEE***EEEE****EEE****EE*EEB
BEEE*EEEE*EEE*EE*EE*EEEEE*EEE*EE*EEEEEE*EEEEEE*EEB
BEEE*EEEE*****EE*EE*EEEEE*EEE*EEE***EEEE***EEE*EEB
BEEE*EEEE*EE*EEE*EE*EEEEE*EEE*EEEEEE*EEEEEE*EE*EEB
BEEE*EEEE*EEE*EE*EE****EEE***EEE****EEE****EEE*EEB
BEBBBBBBBBBBBBBBBBBBBBBBBBBBBBBBBBBBBBBBBBBBBBBBEB
BEBBBBBBBBBBBBBBBBBBBBBBBBBBBBBBBBBBBBBBBBBBBBBBEB
BEEEEEEEE*****EE*****EE***EEEE*****EEE***EEEEEEEEB
BEEEEEEEE*EEE*EE*EEEEEE*EE*EEE*EEE*EE*EEE*EEEEEEEB
BEEEEEEEE*****EE***EEEE*EEE*EE*****EE*EEE*EEEEEEEB
BEEEEEEEE*EEEEEE*EEEE*E*EE*EEE*EE*EEE*EEE*EEEEEEEB
BEEEEEEEE*EEEEEE*****EE***EEEE*EEE*EEE***EEEEEEEEB
BEEEEEEEEEEEEEEEEEEEEEEEEEEEEEEEEEEEEEEEEEEEEEEEEB
BEEEEEEEEEEEEEEEEEEEEEBBBBBBEEEEEEEEEEEEEEEEEEEEEB
BEEEEEEEEEEEEEEEEEBBBBBBBBBBBBBBEEEEEEEEEEEEEEEEEB
BBBBBBBBBBBBBBBBBBBBBBBBBBBBBBBBBBBBBBBBBBBBBBBBBB