140
50 50
120
1.5 1.22
-
BBBBBBBBBBBBBBBBBBBBBBBBBBBBBBBBBBBBBBBBBBBBBBBBBB
BMEEEEEEEEEEEEEEEEEEEEEEEEEEEEEEEEEEEEEEEEEEREEEEB
BEEEEEEEEEEEEEEEEEEEEEEEEREEEEEEEEEEEEEEEEEEEEEEEB
BEEEEEEEEEEEEEEEEEEEEEEEEEEEEEEEEEEEEEEEEEEEEEEEEB
BEEEEEEEEEEEEEEEEEEEEEEEEEEEEEEEEREEEEEEEEREEEEEEB
BEEEEEEEEEREEREEREEEEEEEEEEEEEEEEEEEEEEEEEEEEREEEB
BEEEEEEEEEEEEEEEEEEEREEEEEEEEEEEEEEEEEEEEEEEEEEEEB
BERREREEEEEEEREEEEEEEEEEEEEEEEEEEEREEEEEEEERREEEEB
BEERREEE    EEEEE   SEEEEEEEEE    EEEEEEEEEEEEREEB
BEEEEEEE   *EE*EE   *EEEE*EEEES  *EEEEEEEEEEEEEEEB
BEREEEEE   SEEEEE    EEEEEEEEE    EEEEEEEEEEEEEEEB
BE*EEEEEEERRERREEEEEEEEEEEEEEEEEEEEEEEEEEEEEEEEEEB
BEEEEEEEEEEEEEEEEEEEEEEEEEEEEEEEEEEEEEEEEEEEEEEEEB
BEEEEEEEEEEEEEEEEEEEEEEEEEREEEEEEEEEEEEEEEEEEEEEEB
BEEEEEEEEEEEEEEEEEEEEEEEEEEEEEEEEEEEEEEEEEEEEEEEEB
BEEEEEEE    EEEEE  S EEEEEEEEES   EEEEEEEEEEEREREB
BEEEEERES  *EEEEE   *EEEEEEEEE *  EEEEEEEEEEREREEB
BEEEEEEE    EEEEE    EREREEEEE    EEEEEEEEEEEEEEEB
BEEEEEEEEEEEEREEREEEEEEEEEEEEEEEEEEEREEEEEEEEEEEEB
BEEEEEREREEEEEEEEEEEEEEEEEEREREEEEEEEEEEEEEEEEEEEB
BEEEEEEREEEEEEREREEEEEEEEEEEEEEEEEEEEEEEREEREEEEEB
BEEEEEEEEEREEEEREEEEEEEREEEEEEEEEEEEEEEEEEEEEEEEEB
BEEEEEEREEREEEEREEEREEEEEEEEEEEEEEEE*EEEEEEEEEEEEB
BEEEE*EEEREREREEEEERREEEEE*EEEEE*EEEEEEEEEEEEEEEEB
BEEEEEEEEEEEEEEEEEEEEEEEEEEEEEREEE*EEEEEEEEREEE*EB
BEEEEERE *S EEEEEE  *SEEEEEEEE*S  EEEEEEEEEEEEEEEB
BEEEREEE    EEEEEE    EEEEREEE    EEEEEREEEEEEEEEB
BEEEEEER    EEEEEE    EEEEEEEE    EEEREEEEEEREEEEB
BEEEEEEEEEEEEREEEREEEEEEEEEEEEEEEEEEEEEEEEEEEEEEEB
BEEEEEEEEEEEEEEEEEEEEEEEEEEEEEEEEEEEEEEEEEEEEEEEEB
BEEEEEEEEEEEEEEEEEEEEEEEEEEEEEEEEEEEEEEEEEEEEEEEEB
BEEEEEEEEEEEEEEEEEEEEEEEEEEEEEEEEEEEEEEEEEEEEEEEEB
BEEEEEEEEEEEEEEEEEEEEEEEEEEEEEEREEEEEEEEEEEEEEEEEB
BEEEEEEEEEEEEEEEEEEEEEEEEEEEEEEEEEEEEEEEEEEEEEEEEB
BEEEEEEEEEEEEEEE      !       EREEEEEEEEEEEEEEEEEB
BEEEEEEEEEEEEEEE              EEEEEEEEEEEEEEEEEEEB
BEEEREEEEEEEEEER              EEEEEEEEEEEEEEEEEEEB
BEEEEEEEEREEEEEE     ***      EEEREEEEEEEEEEEEEEEB
BEEEEEEEEEEEEEEE     ***      EEEEEEEEEEEEEEEEEEEB
BEEEEREEE*EEEEEE     ***      EEEEEEEEEEEEEEEEEEEB
BEEREEEEEEE*EEEE              EEEEEEEEEEEEEEEEEEEB
BEEREEEE*EEEEEEE              EEEEEEEEEEEEEEEEEEEB
BEEEEEEE*EEEEEEEEEEEEEEEEEEEEEEEREEEEEEEEEEEEEEEEB
BEEEREE*EEEEEEEEEEEEEEEE*EEEEEREEEEEREEEEEEEEEEEEB
BEEEEEEEEEEEEEEEEE*EEEEEEEEEEEEEEEEEEEEEEREEEEEEEB
BEEEEEEEEEEEEEEEEEEEEEEEEEEEEEEEEEEEEEEEEEEREEEEEB
BEEEEE*EEEEEEEEEEE*EEEEEEEEEEEEEEEEEEEEEEEEEEEEEEB
BEEEEEEEEEEEEEEEEEEEEEEEEEEEEE*EEEEEEE*EEEEEEEEEEB
BEEEEEEEEEEEEEEEEEEEEEEEEEEEEEEEEEEEEEEEEEEEEEEEEB
BBBBBBBBBBBBBBBBBBBBBBBBBBBBBBBBBBBBBBBBBBBBBBBBBB